NO                 ./path_to_the_north_texture          
SO      ./path_to_the_south_texture
EA      ./path_to_the_east_texture


WE      ./path_to_the_west_texture                     
 
  
   
    
     
      

       
        
         
          


F 220,100,0 



        C 1,1,1
      1111111111111111111111111      
      1111111111111111111111111
      1000001000100000000011  
      100000010001000000001  
      100000001010000000001 
      100000000100000N000001       
     10000000000000000000011     
    11111111111101111111111111
1111111111111111111111111111
1111111 111111111 111111111
