NO                 /~/C255,30,0         
SO      path_to_the_south_texture
EA      WE 
NO we





 
   
    
     
      

       
        
         

        C 255,30,0
F 255,30,0 
111111111111111111111111111111111111111111111
111111111111111111111111111111111111111111111
      1111111111111111111111111     
     1000000000110001001S00001     
    11111111111111111111111111
1111111111111111111111111111
1111111 111111111 111111111
111111111111111111111111111111111111