NO      textures/Prototype_Textures/Orange.xpm
SO      textures/Prototype_Textures/Orange.xpm
EA      textures/Prototype_Textures/Orange.xpm
WE      textures/Prototype_Textures/Orange.xpm                     


F 220,100,100 
C 156,255,255


1111111111111111111111111      
1111111111111111111111111
1000001000110000000000011
1000001000110000000000011
1000000010110000000000001 
100000000100000W000000001      
1000000000000000000000011     
1111111111110111111111111
1111111111111111111111111
1111111111111111111111111
