NO                 ./path_to_the_north_texture          
F 220,100,0 
WE      ./path_to_the_west_texture
SO      ./path_to_the_south_texture
EA      ./path_to_the_east_texture                                                              
C 255,30,0

1111111111111111111111111
100000N000110001001000001

1111111111111111111111111